_|___|___|___|___|___|___|___|___|___|___|___|___|___|___|___|___|___|
___|___|___|___|___|___|___|___|___|___|___|___|___|___|___|___|___|__
_|___|___|___|___|___|___|___|___|___|___|___|___|___|___|___|___|___|
___|___|___|___|___|___|___|___|___|___|___|___|___|___|___|___|___|__
_|___|___|___|___|___|___|___|___|___|___|___|___|___|___|___|___|___|
___|___|___|___|___|___|___***************_|___|___|___|___|___|___|__
_|___|___|___|___|___|___|_** | | | | | **___|___|___|___|___|___|___|
___|___|___|___|___|___|___** | | | | | **_|___|___|___|___|___|___|__
_|___|___|___|___|___|___|_***************___|___|___|___|___|___|___|
___|___|___|___|___|___|___|___|___|___|___|___|___|___|___|___|___|__
_|___|___|___|___|___|___|___|___|___|___|___|___|___|___|___|___|___|
___|___|___|___|___|___|___|___|___|___|___|___|___|___|___|___|___|__
_|___|___|___|___|___|___|___|___|___|___|___|___|___|___|___|___|___|
___|___|___|___|___|___|___|___|___|___|___|___|___|___|___|___|___|__
_|___|___|___|___|___|___|___|___|___|___|___|___|___|___|___|___|___|
___|___|___|___|___|___|___|___|___|___|___|___|___|___|___|___|___|__
_|___|___|___|___|___|___|___|___|___|___|___|___|___|___|___|___|___|
___|___|___|___|___|___|___|___|___|___|___|___|___|___|___|___|___|__
