        ****************************
        ** ---------------------- **
        ** |  |  |  |  |  |  |  | **
        ** |  |  |  |  |  |  |  | **
        ** |  |  |  |  |  |  |  | **
        ** ---------------------- **
        ****************************
