****************************
** ---------------------- **
** |  |  ^^^  ^^^ |  |  | **
** |  | / o \/ o \|  |  | **
** |  | \___/\___/|  |  | **
** |  |  |  |  |  |  |  | **
** ---------------------- **
****************************
