****************************
** ---------------------- **
** |  |  __\  /__ |  |  | **
** |  | / o \/ o \|  |  | **
** |  |  |  |  |  |  |  | **
** |  |  |  |  |  |  |  | **
** ---------------------- **
****************************
