****************************
** ---------------------- **
** |  |  ___  ___ |  |  | **
** |  | / o \/ o \|  |  | **
** |  | \___/\___/|  |  | **
** |  |  |  |  |  |  |  | **
** ---------------------- **
****************************
